학번,이름,출석,과제,중간,기말,합계,등수
1,kim,10,10,10,101,131,1
2,kim,11,11,11,11,44,19
3,kim,12,12,12,12,48,18
4,kim,13,13,13,13,52,17
5,kim,14,14,14,14,56,16
6,kim,15,15,15,15,60,15
7,kim,16,16,16,16,64,14
8,kim,17,17,17,17,68,13
9,kim,18,18,18,18,72,12
10,kim,19,19,19,19,76,11
11,kim,20,20,20,20,80,10
12,kim,21,21,21,21,84,9
13,kim,22,22,22,22,88,8
14,kim,23,23,23,23,92,7
15,kim,24,24,24,24,96,6
16,kim,25,25,25,25,100,5
17,kim,26,26,26,26,104,4
18,kim,27,27,27,27,108,3
19,kim,28,28,28,28,112,2
